##########
#        #
#        #
#        #
#        #
# @$  .  #
#        #
#        #
#        #
#        #
##########