###############
#             #
#             #
# @$    .     #
#             #
#             #
###############